##########
#P      X#
#        #
#        #
#        #
#        #
#        #
#        #
#       O#
##########