##########
#P      X#
#        #
#        #
#        #
#        #
#        #
#        #
#X      O#
##########