##########
#P      X#
#        #
#        #
#        #
#        #
#        #
#        #
#X      X#
##########